    abject	- of the most contemptible kind
    aberration	-    a state or condition markedly different from the norm
    abjure	-    formally reject or disavow a formerly held belief
    abnegation	-    the denial and rejection of a doctrine or belief
    abrogate	-    revoke formally
    abscond	-    run away, often taking something or somebody along
    abstruse	-    difficult to penetrate
    accede	-    yield to another's wish or opinion
    accost	-    approach and speak to someone aggressively or insistently
    accretion	-    an increase by natural growth or addition
    acumen	-    shrewdness shown by keen insight
    adamant	-    impervious to pleas, persuasion, requests, reason
    admonish	-    scold or reprimand; take to task
    adumbrate	-    describe roughly or give the main points or summary of
    adverse	-    in an opposing direction
    advocate	-    a person who pleads for a person, cause, or idea
    affluent	-    having an abundant supply of money or possessions of value
    aggrandize	-    embellish; increase the scope, power, or importance of
    alacrity	-    liveliness and eagerness
    alias	-    a name that has been assumed temporarily
    ambivalent	-    uncertain or unable to decide about what course to follow
    amenable	-    disposed or willing to comply
    amorphous	-    having no definite form or distinct shape
    anachronistic	-    chronologically misplaced
    anathema	-    a formal ecclesiastical curse accompanied by excommunication
    annex	-    attach to
    antediluvian	-    of or relating to the period before the biblical flood
    antiseptic	-    thoroughly clean and free of disease-causing organisms
    apathetic	-    showing little or no emotion or animation
    antithesis	-    exact opposite
    apocryphal	-    being of questionable authenticity
    approbation	-    official acceptance or agreement
    arbitrary	-    based on or subject to individual discretion or preference
    arboreal	-    of or relating to or formed by trees
    arcane	-    requiring secret or mysterious knowledge
    archetypal	-    of an original type after which other things are patterned
    arrogate	-    seize and take control without authority
    ascetic	-    someone who practices self denial as a spiritual discipline
    aspersion	-    a disparaging remark
    assiduous	- marked by care and persistent effort
    atrophy	- a decrease in size of an organ caused by disease or disuse
    bane	-    something causing misery or death
    bashful	-    self-consciously timid
    beguile	-    influence by slyness
    bereft	-    sorrowful through loss or deprivation
    blandishment	-    flattery intended to persuade
    bilk	-    cheat somebody out of what is due, especially money
    bombastic	-    ostentatiously lofty in style
    cajole	-    influence or urge by gentle urging, caressing, or flattering
    callous	-    emotionally hardened
    calumny	-    a false accusation of an offense
    camaraderie	-    the quality of affording easy familiarity and sociability
    candor	-    the quality of being honest and straightforward
    capitulate	-    surrender under agreed conditions
    carouse	-    engage in boisterous, drunken merrymaking
    carp	-    any of various freshwater fish of the family Cyprinidae
    caucus	-    meet to select a candidate or promote a policy
    cavort	-    play boisterously
    circumlocution	-    an indirect way of expressing something
    circumscribe	-    draw a geometric figure around another figure
    circumvent	-    surround so as to force to give up
    clamor	-    utter or proclaim insistently and noisily
    cleave	-    separate or cut with a tool, such as a sharp instrument
    cobbler	-    a person who makes or repairs shoes
    cogent	-    powerfully persuasive
    cognizant	-    having or showing knowledge or understanding or realization
    commensurate	-    corresponding in size or degree or extent
    complement	-    something added to embellish or make perfect
    compunction	-    a feeling of deep regret, usually for some misdeed
    concomitant	-    following or accompanying as a consequence
    conduit	-    a passage through which water or electric wires can pass


    
